WWWWWWWWWWWWWWWW
W--------------W
W--------------W
W--WWWWWWWWWW--W
W--WWWWWWWWWW--W
W--WW----------W
W--WW------ww--W
W--WWWWWWW-----W
W--WWWWWWW-----W
W--WW----------W
W--WW----tttt--W
W--------------W
Wb--wwwww------W
WWWWWWWWWWWWWWWW
