##############
#------------#
#-t--------t-#
#------------#
#----c-c-----#
#------------#
#-------c----#
#----c-------#
#-----------c#
#-----------c#
#------------#
#-t--------t-#
#------------#
##############
