WWWWWWWWWWWWWWWW
W----------wwwtW
W------------w-W
W--------------W
W--------------W
W--------ww----W
W--------ww----W
W--------------W
W--------------W
W--------------W
Wt--w----------W
WWWWWWWWWWWWWWWW
