WWWWWWWWWWWWWWWW
W-----c--c-----W
W--------------W
W--------------W
W--------------W
W--------------W
W--------------W
W--------------W
W--------------W
W--------------W
W-----c--c-----W
WWWWWWWWWWWWWWWW
