WWWWWWWWWWWWWWWW
W--------------W
W----c--c------W
W--WWWWWWWWWW--W
W--WWWWWWWWWW--W
W--WW--c--c----W
W--WW----------W
W--WW---b------W
W--WW----------W
W--WW------tt--W
W--WW-c----tt--W
W--------------W
W-----c--------W
WWWWWWWWWWWWWWWW
