WWWWWWWWWWWWWWWW
WW------------WW
W--------------W
W--WW--ww--WW--W
W--WW--WW--WW--W
W------tt------W
W--------------W
W--WWt-WW-tWW--W
W--WWt-WW-tWW--W
W--------------W
W------tt------W
W--WW--WW--WW--W
W--WW--ww--WW--W
W--------------W
WW------------WW
WWWWWWWWWWWWWWWW
