WWWWWWWWWWWWWWWWWWWWWWWWWWWWWWWWWWWW
W-----tW-r-r----------------WWWWWWWW
W------W--w-----------w-----WWWWWWWW
W------W-w---w-------ww-----WWWWWWWW
WW---WWWWWWWWWW------WWW----WWWWWWWW
W-----c------------------c---------W
W--r-------------------------------W
W------------------r---------------W
W------------c---------------------W
W---WWWWWW--WWW------WWWW---WW---WWW
W------W------W------W------W------W
W------W------W------W--cc--W------W
W--t---W--b---W---bb-W------W---r-tW
WWWWWWWWWWWWWWWWWWWWWWWWWWWWWWWWWWWW
