################
#WWWWWW--WWWWWW#
#W----W--W----W#
#W-t--------t-W#
#W----c--c----W#
#W----W--W----W#
#W----c--c----W#
#W----W--W----W#
#WW-cWc--cWc-WW#
#--------------#
#--------------#
#WW-cWc--cWc-WW#
#W----W--W----W#
#W----c--c----W#
#W----W--W----W#
#W----c--c----W#
#W-t--------t-W#
#W----W--W----W#
#WWWWWW--WWWWWW#
################
