WWWWWWWW
WWW--WWW
WW----WW
W------W
W--tt--W
W------W
W------W
W------W
W------W
W------W
W------W
W------W
W------W
W------W
W------W
W------W
W------W
W--tt--W
W------W
WW----WW
WWW--WWW
WWWWWWWW
