WWWWWWWWWWWWWWWW
W--------------W
W-t----------t-W
W--------------W
W--------------W
W----www-------W
W----www-------W
W--------------W
W--------------W
W--------------W
W--------------W
W--------------W
W--------------W
W-t----------t-W
W--------------W
WWWWWWWWWWWWWWWW
