WWWWWWWWWWWWWWWWWWWWWWWWWWWWWWWWWWWWWWWWWWWWWWWWWWWWWW
WWWWWWWWWWWWWWWWWWWWWWWWWW--WWWWWWWWWWWWWWWWWWWWWWWWWW
WWWWWWWWWWWWWWWWWWWWWWWWWW--WWWWWWWWWWWWWWWWWWWWWWWWWW
WWWWWWWWWWWWWWWWWWWWWWWWWW--WWWWWWWWWWWWWWWWWWWWWWWWWW
WWWWWWWWWWW--------------------WWWWWWWWWWWWWWWWWWWWWWW
WWWWWWWWW----WWWWWWWWWWWWWWWW--WWWWWWWWWWWWWWc--rWWWWW
WWWWWWWWW----Wc----------------WWWWWWWWWW--------rWWWW
WWWWWWr------W-----------------W----------w----------W
W------------Wc----------------W-------wwwww---------W
W-----------cW-----------------W---------www---------W
WWWWWWWWWWWWWWc----------------W--------ww--------WWWW
WWWWWWWWWWWWWW-----------------W------------------WWWW
WWWWWWWWWWWWWWc----------------W-----rr--------rWWWWWW
WWWWWWWWWWWWWWWWWWWWWW--WWWWWWWW-------------rWWWWWWWW
WWWWWWWWWWWWW--------------------------cWWWWWWWWWWWWWW
WWWWWWWWWWWWWW---rr------r------WWWWWWWWWWWWWWWWWWWWWW
WWWWWWWWWWWWWWWWWWWWWWWWWW--WWWWWWWWWWWWWWWWWWWWWWWWWW
WWWWWWWWWWWWWWWWWWWWWWWWWWWWWWWWWWWWWWWWWWWWWWWWWWWWWW
