WWWWWWWWWWWWWWWWWWWWWWWWWWWWWWWWWWWWWWWWWWWWWW
WWWWWWWWWWWWWWWWWWWWW----WWWWWWWWWWWWWWWWWWWWW
WWWWWWWWWWWWWWWWWWWWW----WWWWWWWWWWWWWWWWWWWWW
WWWWWWWWWWWWWWWWWWWWW----WWWWWWWWWWWWWWWWWWWWW
WWWWWWWWWWWWWWWW---cW----Wc---WWWWWWWWWWWWWWWW
WWWWWWWWWWWWWWWW---cW----Wc---WWWWWWWWWWWWWWWW
W-----------------WWW----WWW-----------------W
W-----------------WWW----WWW-----------------W
W--WWWWWWWWWWWWW--WWW----WWW--WWWWWWWWWWWWW--W
W--WWWWWWWWWWWWW--WWW----WWW--WWWWWWWWWWWWW--W
W--WWWWWWWWWW-----WWW----WWW-----WWWWWWWWWW--W
W---WWWWWWWW------WWW----WWW------WWWWWWWW---W
W-----------------WWW----WWW-----------------W
W-----------------WWW----WWW-----------------W
W-----------------WWWWWWWWWW-----------------W
WWWWWWWWWWWW------WWWWWWWWWW------WWWWWWWWWWWW
WWWWWWWWWWWWW-----WWWWWWWWWW-----WWWWWWWWWWWWW
WWWWWWWWWWWWWW------------------WWWWWWWWWWWWWW
WWWWWWWWWWWWWWW----------------WWWWWWWWWWWWWWW
WWWWWWWWWWWWWWWWWWWWWW--WWWWWWWWWWWWWWWWWWWWWW
WWWWWWWWWWWWWWWWWWWWWW--WWWWWWWWWWWWWWWWWWWWWW
WWWWWWWWWWWWWWWWWWWWWW--WWWWWWWWWWWWWWWWWWWWWW
WWWWWWWWWWWWWWWWWWWWWW--WWWWWWWWWWWWWWWWWWWWWW
WWWWWWWWWWWWWWWWWWWWWWWWWWWWWWWWWWWWWWWWWWWWWW
