WWWWWWWWWWWWWWWW
W--------------W
W--------------W
W--WWWWWWWWWW--W
W--WWWWWWWWWW--W
W--WW----------W
W--WW----------W
W--WW---b------W
W--WW----------W
W--WW------tt--W
W--WW------tt--W
W--------------W
W--------------W
WWWWWWWWWWWWWWWW
