WWWWWWWWWWWWWWWWWWWWWWWWWWWWWWWWWWWWWWWWWWWWWWWWWWWWWW
W-----tW-----tW-----tW-r-r------------------W-------tW
W------W------W------W--w----------------------------W
W------W------W------W-w---w----------------W--------W
WWW--WWWWWWW-WWWWW-WWWWWWWWWW---WWWWWWW-----WWWWWWW-WW
W----------------------W--------------W-----W--------W
W--r-----------------------------W----W--------------W
W------WWWWWWWWWWWWWWWWWWWWWWWWWWWW--tW--------------W
W--w---W--b---W-----------------------W-----W--------W
W----w-W------------------------------W-----WWW-WWWWWW
W------W------WW-WWWWW--WWWWWWWWWWWWWWW-----W--------W
W------W------W------W-------------------------------W
W--t---W--b---W---bb-W---------r------------Wt------tW
WWWWWWWWWWWWWWWWWWWWWWWWWWWWWWWWWWWWWWWWWWWWWWWWWWWWWW
