WWWWWWWWWWWWWWWW
W-------------tW
W--------------W
W--------------W
W--------------W
W--------------W
W--------------W
W--------------W
W--------------W
W--------------W
Wt-------------W
WWWWWWWWWWWWWWWW
