##############
#------www---#
#-t-----ww-t-#
#--------ww--#
#----c-c-www-#
#------wwww--#
#------wc----#
#----cwww----#
#-----------c#
#------w----c#
#-----www----#
#-t----w---t-#
#------------#
##############
