WWWWWWWWWWWWWWWWWWWWWWWWWWWWWWWWWWWWWWWWWWWWWWWWWWWWWW
W------------------------------WWWW------------------W
W----------------------------------------------------W
W---------------------------------------------WWW----W
W----WWWWWWWWWWWWWWWWWWWWW---------WWWWW------WWW----W
W---------------WWWWWWWWWW------c--WWWWW------WWW----W
W---------------WWWWWWWWWWWWWWWWWWWWWW--------WWW----W
W---------------WWWWWWWWWWWWWWWWWWWWWW--------WWW----W
W---WWWWWWWW----WWWWWWWWWWWWWWWWWWWWWW----WWWWWWW----W
W--bWW---------------------------------------WWWW----W
W--bWW---------------------------------------WWWW----W
WWWWWW------WWWWWWWWWWWWWWWWWWWWWWWWWWWWW----WWWW----W
WWWWWW----------c-------------------c-----------W----W
W----W------------------------------------------W----W
W----W------------------------------------------W----W
W-----------------------------------------------W----W
W----------t-t-t-t-t-t-t-t--t-t-t-t-t-t-t-t-----W----W
W-------------------------------------c---------W----W
W----W-----t-t-t-t-tct-t-t--t-t-t-t-t-t-t-t-----W----W
W----W------------------------------------------W----W
W----W-----t-t-t-t-t-t-t-t--t-t-t-t-t-t-t-t-----W----W
W----W----------c-------------------------------W----W
W----W-----t-t-t-t-t-t-t-t--t-t-tct-t-t-t-t-----W----W
W----W------------------------------------------W----W
W----W-----t-t-t-t-t-t-t-t--t-t-t-t-t-t-t-t-----W----W
W----WW-----c----------------------------------WW----W
W---cWWWWWWWWWWWWWWWWW----------WWWWWWWWWWWWWWWWWc---W
W----------------------------------------------------W
W----------------------------------------------------W
WWWWWWWWWWWWWWWWWWWWWWWWWWWWWWWWWWWWWWWWWWWWWWWWWWWWWW
