WWWWWWWWWWWWWWWWWW
WWWWWWWW--WWWWWWWW
WWW------------WWW
WWW------------WWW
WWW--------------W
WWW--------------W
WWWWW-WWWWWWWWW--W
WWWWW-WWWWWWWWW--W
WWWW---------cW--W
WWWW----------W--W
W-------------W--W
W-------------W--W
W-------------WWWW
WWWWc---------WWWW
WWWWWWWWWWW-W-WWWW
WWWcccW----------W
WWW---W----------W
WWW---W----------W
WWW---W----------W
WWW--------------W
WWW--------------W
WWWWWWWWWWWWWWWWWW
