WWWWWW
Wb--bW
W----W
W----W
W----W
W----W
W---tW
W--WWW
W----W
W----W
W----W
W-bb-W
W-bb-W
W----W
W----W
W----W
WWW--W
Wt---W
W----W
W----W
W----W
W----W
Wb--bW
WWWWWW
