WWWWWWWWWWWWWWWWWWWWWWWWWWWWWWWWWWWWWWWWWWWWWWWWWWWWWW
WWW----------------------------WWWW---WWWWWWWWW----WWW
WWW--WWWWWWWWWWWWWWWWWWWWW-----WWWW----------------WWW
W----WWWWWWWWWWWWWWWWWWWWW-----------WWWWWWW--WWW----W
W---------------WWWWWWWWWW------c-WWWWWWWWWW--WWWc---W
W---------------WWWWWWWWWWWWWWWWWWWWWW--------WWW----W
W---WWWWWWWWWW--WWWWWWWWWWWWWWWWWWWWWW--WWWWWWWWW----W
W--bWW---------------------------------------WWWW----W
WWWWWW------WWWWWWWWWWWWWWWWWWWWWWWWWWWWW----WWWW----W
WWWWWW----------c-------------------c-----------W----W
W----W------------------------------------------W----W
W----W------------------------------------------W----W
W-----------------------------------------------W----W
W----------t-t-t-t-t-t-t-t--t-t-t-t-t-t-t-t-----W----W
W----------t-t-t-t-t-t-t-t--t-t-t-t-t-c-t-t-----W----W
W----W-----t-t-t-c-t-t-t-t--t-t-t-t-t-t-t-t-----W----W
W----W-----t-t-t-t-t-t-t-t--t-t-t-t-t-t-t-t-----W----W
W----W-----t-t-t-t-t-t-t-t--t-t-t-t-t-t-t-tw----W----W
W----W-----t-t-t-t-t-t-t-t--t-t-t-t-t-t-t-t-----W----W
W----W-----t-t-t-tct-t-t-t--t-t-t-c-t-t-t-t-----W----W
W----W-----t-t-t-t-t-t-t-t--t-t-t-t-t-t-t-t-----W----W
W----W-----t-t-t-t-t-t-t-t--tct-t-t-t-t-t-t-----W----W
W----WW----------------------------------------WW----W
W---cWWWWWWWWWWWWWWWWW----------WWWWWWWWWWWWWWWWWc---W
W----------------------------------------------------W
WWWWWWWWWWWWWWWWWWWWWWWWWWWWWWWWWWWWWWWWWWWWWWWWWWWWWW
