WWWWWWWWWWWWWWWWWW
W----------------W
W-t------------t-W
WWWWWWWWWW-------W
W----------------W
W----------------W
W----------------W
W----------------W
W-------WWWWWWWWWW
W-t------------t-W
W----------------W
WWWWWWWWWWWWWWWWWW
