WWWWWWWWWWWWWW
W------------W
W-t--------t-W
W------------W
W------------W
W-----www----W
W-----w-w----W
W-----www----W
W------------W
W------------W
W------------W
W-t--------t-W
W------------W
WWWWWWWWWWWWWW
