WWWWWWWWWWWWWWWWWWWWWWWWWWWWWWWWWWWWWWWWWWWWWWWWWWWWWWWWWWWWWWWWWWWWWWWW
W-------------------W--------------------------------------------------W
W-------------------W-------------------------------W------------------W
W-------------------W-----------WWWWWWWWWW----------W----------W-------W
W-------------------W-------------------------------W-----tt---W-------W
W-------------------W------W------------------------W-ww---W-WWW-------W
W-------------------W------W-------------------------------------------W
W-----WWWWW---------W------W-------------------------------------------W
W-----W---W---------W------WWWWW----------------------WWWWWWWWWWWWWWWWWW
W-----WWWWWW---------------W-t------------------------W-----------------
W-----Wt-------------------W--------------------------W-----------------
WWWWWWWWWWWWWWWWWWWWWWWWWWWWWWWWWWWWWWWWWWWWWWWWWWWWWWW-----------------
