WWWWWWWW
Wb----bW
W------W
W------W
W------W
W------W
W-----WW
W----WcW
W---W--W
W--W---W
W------W
W--ww--W
W--ww--W
W------W
W---W--W
W--W---W
WcW----W
WW-----W
W------W
W------W
W------W
W------W
Wb----bW
WWWWWWWW
