WWWWWWWWWWWWWWWWWWWWWWWWWWWWWWWWWWWWWWWWWWWWWWWWWWWWWWWWWWWWWWWWWWWWWWWW
W-------------------W--------------------------------------------------W
W-------------------W-------------------------------W------c-----------W
W---------------c---W-----------WWWWWWWWWW----------W----------W-------W
W----c--------------W---------------c---------------W--c--tt---W-------W
W-------------------W------W------------------------W-ww---W-WWW-------W
W-------------------W------W-------------------------------------------W
W-----WWWWW---------W------W---------c----------c-------------c--------W
W-----WwwwW---------W------WWWWW----------------------WWWWWWWWWWWWWWWWWW
W-----WWWWWW---------------W-t---------------------rrrWWWWWWWWWWWWWWWWWW
W-----Wt-------------------W--------------------r--rrrWWWWWWWWWWWWWWWWWW
WWWWWWWWWWWWWWWWWWWWWWWWWWWWWWWWWWWWWWWWWWWWWWWWWWWWWWWWWWWWWWWWWWWWWWWW
